WWWWWWWWWW
W        W
W   S    W
W   H    W
WWWWWWWWWW
WWWWWWWWWW
W        W
W        W
W        W
WWWWWWWWWW